50
11
26 0 0 0 0 14 9 0 0 0 0 0 0 0 0 0 0 0 0 0 0 0 0 0 0 0 0 0 0 0 0 0 12 13 25 26 0 0 0 0 0 0 0 7 11 12 13 6 11 15
26 15 12 13 0 23 24 0 0 0 0 0 0 0 0 0 0 0 12 13 15 0 0 0 0 0 0 0 0 0 0 0 23 29 30 26 0 0 0 0 0 0 0 23 22 22 22 22 22 29
27 28 22 24 0 25 26 10 7 0 0 0 0 0 0 0 23 22 22 22 24 0 0 0 0 0 0 0 35 36 37 0 33 32 32 26 0 0 0 0 0 0 0 33 31 31 31 31 31 32
32 31 31 34 0 25 27 28 24 0 0 35 36 37 0 0 33 31 31 31 34 0 23 24 0 0 0 0 0 0 0 0 25 32 32 26 14 9 23 24 0 0 0 0 0 0 0 0 0 25
26 0 0 0 0 33 31 31 34 0 0 0 0 0 0 0 0 0 0 0 0 0 25 26 0 0 0 0 0 0 0 0 33 31 31 27 28 29 30 26 0 0 0 0 0 0 0 12 13 25
26 0 0 0 0 0 0 0 0 0 0 0 0 0 0 0 0 0 0 0 0 0 25 26 11 14 0 35 36 37 0 0 0 0 0 0 0 0 33 34 35 36 37 0 0 0 0 23 29 30
26 0 0 0 0 0 0 0 0 0 0 0 35 36 37 0 0 0 0 0 0 0 25 27 28 24 0 0 0 0 0 0 0 0 0 0 0 0 0 0 0 0 0 0 0 0 0 33 31 32
26 17 17 8 11 0 0 0 0 0 0 0 0 0 0 0 0 0 35 36 37 0 25 32 32 26 12 13 15 11 0 0 0 0 23 24 0 0 0 0 0 0 0 0 35 36 37 0 0 25
27 28 22 22 24 0 7 0 0 12 13 0 0 0 0 0 0 11 10 8 17 17 25 32 32 27 28 22 22 24 0 0 17 17 25 26 8 12 13 7 0 0 0 0 0 6 11 17 17 25
32 32 32 32 26 0 23 22 22 22 24 0 0 35 36 37 0 23 22 22 22 22 30 32 32 32 32 32 32 26 0 0 23 29 30 27 28 22 22 24 0 0 35 36 37 23 22 22 29 30
0 0 0 0 0 0 0 0 0 0 0 0 0 0 0 0 0 0 0 0 0 0 0 0 0 0 0 0 0 0 0 0 0 0 0 0 0 0 0 0 0 0 0 0 0 0 0 0 0 0