5 0 0 0 0 35 30 0 0 0 0 0 0 0 0 0 19 20 0 0 0 0 0 0 0 0 0 0 0 0 0 0 33 34 4 5 0 0 0 0 0 0 0 28 32 33 34 27 32 36
5 36 33 34 0 2 5 0 0 0 0 0 0 0 0 0 40 41 33 34 36 0 19 20 0 0 0 0 0 0 0 0 2 8 9 5 0 0 19 20 0 0 0 2 1 1 1 1 1 8
6 7 1 3 0 4 5 32 28 0 0 0 0 0 0 0 2 1 1 1 5 0 40 41 0 0 0 0 14 15 16 0 12 10 10 5 0 0 40 41 0 0 0 12 10 10 10 10 10 11
11 10 10 13 0 4 6 7 4 0 0 14 15 16 0 0 12 10 10 10 13 0 2 3 0 0 0 0 0 0 0 0 27 17 17 5 35 30 2 3 0 0 0 0 0 0 0 0 0 4
5 0 0 0 0 12 10 10 13 0 0 0 0 0 0 0 0 0 0 0 0 0 4 5 0 0 0 0 0 0 0 0 2 1 1 6 7 8 9 5 0 14 15 16 0 0 0 33 34 4
5 0 0 0 0 0 0 0 0 0 0 0 0 14 15 16 0 0 0 0 0 0 4 5 32 35 0 14 15 16 0 0 12 10 10 10 10 10 10 13 0 0 0 0 0 0 0 2 8 9
5 0 0 0 0 0 0 0 0 14 15 16 0 0 0 0 0 0 0 0 0 0 4 6 7 3 0 0 0 0 0 0 0 0 0 0 0 0 0 0 0 0 0 14 15 16 17 0 12 10 11
5 17 17 29 32 0 0 19 20 0 0 0 0 0 0 0 0 0 14 15 16 0 4 11 11 5 33 34 36 32 0 0 0 0 2 3 0 0 0 0 0 0 0 0 0 0 0 0 0 4
6 7 1 1 3 0 28 40 41 33 34 0 0 0 0 0 0 32 31 29 17 17 4 11 11 6 7 1 1 3 0 0 17 17 4 5 29 33 34 28 0 14 15 16 0 27 32 17 17 4
11 11 11 11 5 0 2 1 1 1 3 0 0 14 15 16 0 2 1 1 1 1 9 11 11 11 11 11 11 5 0 0 2 8 9 6 7 1 1 3 0 0 0 0 0 2 1 1 8 9